NO ./assets/Wall_NO.xpm
SO ./assets/Wall_SO.xpm
WE ./assets/Wall_WE.xpm
EA ./assets/Wall_EA.xpm

F 67,135,94
C 135,206,235

1111111
1000001
10000D1
1111001
1000001
1000001
1111111