C 135,206,235

NO ./assets/Wall_NO.xpm
WE ./assets/Wall_WE.xpm
EA ./assets/Wall_EA.xpm

F 67,205,94
SO ./assets/Wall_SO.xpm


1111111
1000001
10000N1
1110001
1001001
101 101
111 111